{
  "name": "Mapa de Exemplo",
  "width": 25,
  "height": 19,
  "tile_size": 32,
  "background_color": [50, 150, 50],
  "wall_color": [100, 100, 100],
  "data": [
    [1, 1, 1, 1, 1, 1, 1, 1, 1, 1, 1, 1, 1, 1, 1, 1, 1, 1, 1, 1, 1, 1, 1, 1, 1],
    [1, 0, 0, 0, 0, 0, 0, 0, 0, 0, 0, 0, 0, 0, 0, 0, 0, 0, 0, 0, 0, 0, 0, 0, 1],
    [1, 0, 3, 0, 0, 0, 0, 0, 0, 0, 0, 0, 0, 0, 0, 0, 0, 0, 0, 0, 0, 3, 0, 0, 1],
    [1, 0, 0, 0, 0, 0, 0, 0, 0, 0, 0, 0, 0, 0, 0, 0, 0, 0, 0, 0, 0, 0, 0, 0, 1],
    [1, 0, 0, 0, 4, 0, 0, 0, 0, 0, 0, 0, 0, 0, 0, 0, 0, 0, 0, 4, 0, 0, 0, 0, 1],
    [1, 0, 0, 0, 0, 0, 0, 0, 0, 0, 0, 0, 0, 0, 0, 0, 0, 0, 0, 0, 0, 0, 0, 0, 1],
    [1, 0, 0, 0, 0, 0, 5, 5, 5, 5, 5, 5, 5, 5, 5, 5, 5, 0, 0, 0, 0, 0, 0, 0, 1],
    [1, 0, 0, 0, 0, 0, 5, 0, 0, 0, 0, 0, 0, 0, 0, 0, 5, 0, 0, 0, 0, 0, 0, 0, 1],
    [1, 0, 0, 0, 0, 0, 5, 0, 9, 0, 0, 0, 0, 0, 7, 0, 5, 0, 0, 0, 0, 0, 0, 0, 1],
    [1, 0, 0, 0, 0, 0, 5, 0, 0, 0, 0, 30, 0, 0, 0, 0, 5, 0, 0, 0, 0, 0, 0, 0, 1],
    [1, 0, 0, 0, 0, 0, 5, 0, 0, 0, 0, 0, 0, 0, 0, 0, 5, 0, 0, 0, 0, 0, 0, 0, 1],
    [1, 0, 0, 0, 0, 0, 5, 0, 0, 0, 0, 0, 0, 0, 8, 0, 5, 0, 0, 0, 0, 0, 0, 0, 1],
    [1, 0, 0, 0, 0, 0, 5, 5, 5, 5, 5, 5, 42, 5, 5, 5, 5, 0, 0, 0, 0, 0, 0, 0, 1],
    [1, 0, 0, 0, 0, 0, 0, 0, 0, 0, 0, 0, 0, 0, 0, 0, 0, 0, 0, 0, 0, 0, 0, 0, 1],
    [1, 0, 0, 0, 0, 0, 0, 0, 0, 0, 0, 0, 0, 0, 0, 0, 0, 0, 0, 0, 0, 0, 0, 0, 1],
    [1, 0, 0, 20, 0, 0, 0, 0, 0, 0, 0, 0, 0, 0, 0, 0, 0, 0, 0, 21, 0, 0, 0, 0, 1],
    [1, 0, 0, 0, 0, 0, 0, 0, 0, 0, 0, 0, 0, 0, 0, 0, 0, 0, 0, 0, 0, 0, 0, 0, 1],
    [1, 0, 0, 0, 0, 0, 0, 0, 0, 0, 0, 0, 0, 0, 0, 0, 0, 0, 0, 0, 0, 0, 0, 0, 1],
    [1, 1, 1, 1, 1, 1, 1, 1, 1, 1, 1, 1, 2, 1, 1, 1, 1, 1, 1, 1, 1, 1, 1, 1, 1]
  ],
  "portals": [
    {
      "x": 12,
      "y": 18,
      "type": "door",
      "target_map": "map1",
      "target_x": 12,
      "target_y": 1
    },
    {
      "x": 12,
      "y": 12,
      "type": "portal",
      "target_map": "map2",
      "target_x": 12,
      "target_y": 10
    }
  ],
  "objects": [
    {
      "id": 9,
      "x": 8,
      "y": 8,
      "details": {
        "drops": ["item_7", "item_10"]
      }
    },
    {
      "id": 30,
      "x": 11,
      "y": 9,
      "details": {
        "dialog": "Bem-vindo ao mapa de exemplo! Explore os diferentes tipos de objetos."
      }
    }
  ],
  "enemies": [
    {
      "id": 20,
      "x": 3,
      "y": 15,
      "details": {
        "patrol_radius": 3
      }
    },
    {
      "id": 21,
      "x": 19,
      "y": 15,
      "details": {
        "detection_radius": 5
      }
    }
  ],
  "edge_transitions": {
    "left": {"target_map": "map3", "player_x": 23, "player_y": "same"},
    "right": {"target_map": "map4", "player_x": 1, "player_y": "same"},
    "top": null,
    "bottom": null
  }
} 