{
  "name": "Floresta",
  "width": 25,
  "height": 19,
  "tile_size": 32,
  "background_color": [50, 150, 50],
  "wall_color": [100, 100, 100],
  "data": [
    [1, 1, 1, 1, 1, 1, 1, 1, 1, 1, 1, 1, 1, 1, 1, 1, 1, 1, 1, 1, 1, 1, 1, 1, 1],
    [1, 0, 0, 0, 0, 0, 0, 0, 0, 0, 0, 0, 0, 0, 0, 0, 0, 0, 0, 0, 0, 0, 0, 0, 1],
    [1, 0, 3, 0, 6, 6, 6, 0, 0, 0, 0, 0, 0, 0, 0, 0, 0, 6, 6, 6, 0, 3, 0, 0, 1],
    [1, 0, 0, 0, 6, 6, 6, 0, 0, 0, 0, 0, 0, 0, 0, 0, 0, 6, 6, 6, 0, 0, 0, 0, 1],
    [1, 0, 0, 1, 0, 0, 0, 0, 0, 0, 0, 0, 0, 0, 0, 0, 0, 0, 0, 0, 1, 0, 0, 0, 1],
    [1, 0, 4, 0, 0, 0, 0, 0, 0, 0, 0, 0, 0, 0, 0, 0, 0, 0, 0, 0, 0, 4, 0, 0, 1],
    [1, 0, 0, 0, 0, 0, 0, 0, 0, 0, 0, 0, 0, 0, 0, 0, 0, 0, 0, 0, 0, 0, 0, 0, 1],
    [1, 0, 0, 0, 0, 0, 0, 0, 0, 0, 0, 0, 0, 0, 0, 0, 0, 0, 0, 0, 0, 0, 0, 0, 1],
    [1, 0, 0, 0, 0, 0, 0, 0, 9, 0, 0, 0, 0, 0, 0, 0, 7, 0, 0, 0, 0, 0, 0, 0, 1],
    [1, 0, 0, 0, 0, 0, 0, 0, 0, 0, 0, 30, 0, 0, 0, 0, 0, 0, 0, 0, 0, 0, 0, 0, 1],
    [1, 0, 0, 0, 0, 0, 0, 0, 0, 0, 0, 0, 0, 0, 0, 0, 0, 0, 0, 0, 0, 0, 0, 0, 1],
    [1, 0, 0, 0, 0, 0, 0, 0, 0, 0, 0, 0, 0, 0, 0, 0, 8, 0, 0, 0, 0, 0, 0, 0, 1],
    [1, 0, 0, 0, 0, 0, 0, 0, 0, 0, 0, 0, 0, 0, 0, 0, 0, 0, 0, 0, 0, 0, 0, 0, 1],
    [1, 0, 0, 0, 0, 0, 5, 5, 5, 5, 5, 5, 5, 5, 5, 5, 5, 0, 0, 0, 0, 0, 0, 0, 1],
    [1, 0, 0, 0, 0, 0, 5, 5, 5, 5, 5, 5, 5, 5, 5, 5, 5, 0, 0, 0, 0, 0, 0, 0, 1],
    [1, 0, 0, 1, 0, 0, 0, 0, 0, 0, 0, 0, 0, 0, 0, 0, 0, 0, 0, 0, 1, 0, 0, 0, 1],
    [1, 0, 20, 1, 1, 0, 0, 0, 0, 0, 0, 0, 0, 0, 0, 0, 0, 0, 0, 1, 1, 21, 0, 0, 1],
    [1, 0, 0, 0, 0, 0, 0, 0, 0, 0, 0, 31, 0, 0, 0, 0, 0, 0, 0, 0, 0, 0, 0, 0, 1],
    [1, 1, 1, 1, 1, 1, 1, 1, 1, 1, 1, 1, 2, 1, 1, 1, 1, 1, 1, 1, 1, 1, 1, 1, 1]
  ],
  "portals": [
    {
      "x": 12,
      "y": 18,
      "type": "door",
      "target_map": "map2",
      "target_x": 12,
      "target_y": 1
    }
  ],
  "objects": [
    {
      "id": 9,
      "x": 8,
      "y": 8,
      "details": {
        "drops": ["item_7", "item_10"]
      }
    },
    {
      "id": 30,
      "x": 11,
      "y": 9,
      "details": {
        "dialog": "Bem-vindo à Floresta! Cuidado com os slimes e morcegos."
      }
    },
    {
      "id": 31,
      "x": 11,
      "y": 17,
      "details": {
        "dialog": "Tenho itens para vender! Quer dar uma olhada?",
        "shop": true,
        "items_for_sale": ["item_8", "item_10"]
      }
    },
    {
      "id": 12,
      "x": 16,
      "y": 8,
      "details": {
        "message": "Colete moedas para comprar itens com o comerciante."
      }
    }
  ],
  "enemies": [
    {
      "id": 20,
      "x": 2,
      "y": 17,
      "details": {
        "patrol_radius": 3
      }
    },
    {
      "id": 21,
      "x": 21,
      "y": 17,
      "details": {
        "detection_radius": 5
      }
    }
  ],
  "edge_transitions": {
    "left": {"target_map": "map3", "player_x": 23, "player_y": "same"},
    "right": {"target_map": "map4", "player_x": 1, "player_y": "same"},
    "top": null,
    "bottom": null
  }
} 