{
  "name": "Caverna",
  "width": 25,
  "height": 19,
  "tile_size": 32,
  "background_color": [100, 100, 100],
  "wall_color": [50, 50, 50],
  "soundtrack": "music/cave.mp3",
  "data": [
    [1, 1, 1, 1, 1, 1, 1, 1, 1, 1, 1, 1, 2, 1, 1, 1, 1, 1, 1, 1, 1, 1, 1, 1, 1],
    [1, 0, 0, 0, 0, 0, 0, 0, 0, 0, 0, 0, 0, 0, 0, 0, 0, 0, 0, 0, 0, 0, 0, 0, 1],
    [1, 0, 0, 0, 0, 0, 0, 0, 0, 0, 0, 0, 0, 0, 0, 0, 0, 0, 0, 0, 0, 0, 0, 0, 1],
    [1, 0, 0, 0, 0, 0, 0, 0, 0, 0, 0, 0, 0, 0, 0, 0, 0, 0, 0, 0, 0, 0, 0, 0, 1],
    [1, 0, 0, 0, 0, 0, 0, 0, 0, 0, 0, 0, 0, 0, 0, 0, 0, 0, 0, 0, 0, 0, 0, 0, 1],
    [1, 0, 0, 0, 0, 1, 1, 1, 1, 1, 0, 0, 0, 0, 0, 1, 1, 1, 1, 1, 0, 0, 0, 0, 1],
    [1, 0, 0, 0, 0, 1, 0, 0, 0, 1, 0, 0, 0, 0, 0, 1, 0, 0, 0, 1, 0, 0, 0, 0, 1],
    [1, 0, 0, 0, 0, 1, 0, 7, 0, 1, 0, 0, 0, 0, 0, 1, 0, 7, 0, 1, 0, 0, 0, 0, 1],
    [1, 0, 0, 0, 0, 1, 0, 0, 0, 1, 0, 0, 0, 0, 0, 1, 0, 0, 0, 1, 0, 0, 0, 0, 1],
    [1, 0, 0, 0, 0, 1, 1, 0, 1, 1, 0, 0, 42, 0, 0, 1, 1, 0, 1, 1, 0, 0, 0, 0, 1],
    [1, 0, 0, 0, 0, 0, 0, 0, 0, 0, 0, 0, 0, 0, 0, 0, 0, 0, 0, 0, 0, 0, 0, 0, 1],
    [1, 0, 0, 0, 0, 0, 0, 0, 0, 0, 0, 0, 0, 0, 0, 0, 0, 0, 0, 0, 0, 0, 0, 0, 1],
    [1, 0, 0, 0, 0, 0, 0, 0, 0, 0, 0, 0, 0, 0, 0, 0, 0, 0, 0, 0, 0, 0, 0, 0, 1],
    [1, 0, 0, 0, 0, 0, 0, 0, 0, 0, 0, 0, 0, 0, 0, 0, 0, 0, 0, 0, 0, 0, 0, 0, 1],
    [1, 0, 0, 0, 0, 0, 0, 0, 11, 0, 0, 0, 0, 0, 0, 0, 0, 0, 0, 0, 0, 0, 0, 0, 1],
    [1, 0, 0, 0, 0, 0, 0, 0, 0, 0, 0, 0, 0, 0, 0, 0, 0, 0, 0, 0, 0, 0, 0, 0, 1],
    [1, 0, 22, 0, 0, 0, 0, 0, 0, 0, 0, 0, 0, 0, 0, 0, 0, 0, 0, 0, 0, 22, 0, 0, 1],
    [1, 0, 0, 0, 0, 0, 0, 0, 0, 0, 0, 0, 40, 0, 0, 0, 0, 0, 0, 0, 0, 0, 0, 0, 1],
    [1, 1, 1, 1, 1, 1, 1, 1, 1, 1, 1, 1, 2, 1, 1, 1, 1, 1, 1, 1, 1, 1, 1, 1, 1]
  ],
  "portals": [
    {
      "x": 12,
      "y": 0,
      "type": "door",
      "target_map": "map1",
      "target_x": 12,
      "target_y": 17
    },
    {
      "x": 12,
      "y": 18,
      "type": "door",
      "target_map": "map4",
      "target_x": 12,
      "target_y": 1
    },
    {
      "x": 12,
      "y": 9,
      "type": "portal",
      "target_map": "map3",
      "target_x": 12,
      "target_y": 9
    },
    {
      "x": 12,
      "y": 17,
      "type": "stairs_down",
      "target_map": "map4",
      "target_x": 12,
      "target_y": 9
    }
  ],
  "objects": [
    {
      "id": 11,
      "x": 8,
      "y": 14,
      "details": {
        "requires_key": true,
        "key_type": "item_10",
        "target_map": "map3",
        "target_x": 8,
        "target_y": 8
      }
    },
    {
      "id": 12,
      "x": 3,
      "y": 3,
      "details": {
        "message": "Cuidado com os esqueletos! Eles são mais fortes que os slimes."
      }
    }
  ],
  "enemies": [
    {
      "id": 22,
      "x": 2,
      "y": 16,
      "details": {
        "patrol_radius": 4
      }
    },
    {
      "id": 22,
      "x": 21,
      "y": 16,
      "details": {
        "patrol_radius": 4
      }
    }
  ],
  "edge_transitions": {
    "left": null,
    "right": null,
    "top": null,
    "bottom": null
  }
} 